111111
1C0EP1
100001
1000C1
111111
