1111111111111
1111111111111
1E10000000011
1010000000101
1011111010C01
10C0000001011
1P00000010101
1111111111111