1111111111111
1E00000000011
1010000000101
1010000000101
101C000000101
1010000010101
101C000000101
101C000000101
1P00000000001
1111111111111