111111111111111
1E0C0000C0000C1
100000C00000001
100001111110001
1001000C0000001
1C010100000C111
1000P0000000001
111111111111111